低于	低於
行动于	行動於
穿梭于都市	穿梭於都市
彷徨于都市	徬徨於都市
使用本技能后	使用本技能後
余力	餘力
系得	繫得
系兔子	繫兔子
城里	城裡
书里	書裡
放松	放鬆
轻松	輕鬆
松肉锤	肉錘
那块表	那塊錶
大块表	大塊錶
看着表	看著錶
带着表	帶著錶
吵闹的表	吵鬧的錶
这表准吗	這錶準嗎
这表压根	這錶壓根
表都不带	錶都不帶
此表乃是	此錶乃是
我的表上	我的錶上
我的表又坏了	我的錶又壞了
干粮	乾糧
干脆	乾脆
干枯	乾枯
干净	乾淨
干碎	幹碎
我的剑干的	我的劍幹的
那一下干的	那一下幹的
那混蛋干的	那混蛋幹的
干巴士上的活	幹巴士上的活
家伙	傢伙
复活	復活
反复	反覆
覆杂	複雜
覆兴	復興
修覆	修復
恢覆	恢復
覆活	復活
覆仇	復仇
覆习	複習
覆刻	復刻
重覆	重複
覆原	復原
狐貍	狐狸
采访	採訪
采取	採取
采光	採光
说明了	說明了
领悟了	領悟了
写明了	寫明了
证明了	證明了
指明了道路	指明了道路
脏活	髒活
弄脏	弄髒
更脏	更髒
我喜欢脏	我喜歡髒
越来越脏	越來越髒
那个脏袋子	那個髒袋子
心脏	心臟
想象	想像
心象	心像
抵御	抵禦
无振八方钟	無振八方鐘
把钟收	把鐘收
这块钟	這塊鐘
这个钟	這個鐘
冰激凌	冰淇淋
锡制	錫製
冰制	冰製
石制	石製
制作	製作
制成	製成
所制的	所製的
逻辑工作室制	邏輯工作室製
面试	面試
违背	違背
日历	日曆
范围	範圍
借口	藉口
借助	藉助
正借这次	正藉這次
借我之手	藉我之手
还是克制	還是克制
划桨	划槳
开划	開划
给我拼命划	給我拼命划
计划	計畫
云里雾里	雲裡霧裡
尽量	盡量
尽可能	盡可能
收获	收穫
象征	象徵
特征	特徵
关系	關係
别着急	別著急
冲击	衝擊
长枪冲了过去	長槍衝了過去
回应	回應
回归	回歸
呆在	待在
呆着	待著
呆过	待過
呆上	待上
呆太久	待太久
烟斗	菸斗
执念	執念
怀念	懷念
心心念念	心心念念
早间	晨間
表情	表情
一名表情阴郁的残兵	一名表情陰鬱的殘兵
钟表	鐘錶
触碰钟表	觸碰鐘錶
这钟表	這鐘錶
的钟表	的鐘錶
钟表头	鐘錶頭
累累	累累
只能	只能
只有	只有
只属	只屬
只凭	只憑
只留	只留
只为	只為
只买	只買
那只不	那只不
那只食用	那只食用
是只靠	是只靠
是只要	是只要
是只进行	是只進行
是只来得及	是只來得及
是不是只是	是不是只是
一只	一隻
一只只	一隻隻
同一只	同一隻
这只包	這隻包
这只手臂	這隻手臂
这只血魔	這隻血魔
这只小蜘蛛	這隻小蜘蛛
那只是同一只	那隻是同一隻
造就了	造就了
掌握了	掌握了
为了解	為了解
抽象	抽象
扎根	扎根
回合中	回合中
合眼	闔眼
合着眼	闔著眼
合上眼	闔上眼
和面试	和面試
过水面	過水面
油泼面	𰻞𰻞麵
𰻞𰻞面	𰻞𰻞麵
家具	家具
背包	背包
划算	划算
划起船来	划起船來
折射	折射
手折下	手折下
曼怛罗	曼陀羅
曼陀罗	曼陀羅
清剿	通關
荧光	螢光
荧幕	螢幕
朱红	朱紅
罪种放	罪種放
报道	報導
合同	合約
笑料	笑話
土豆	馬鈴薯
视频	影片
兔子门	兔子們
本分	本份
里卡多	里卡多
史宜化	史宜華
呆的地方	待的地方
塑料	塑膠
捱	挨
反应堆	反應爐
盒饭	便當
派送箱	物流箱
註意	注意
服务器	伺服器
匹配	符合
合同工	約聘人員
一目瞭然	一目了然
瞭然於心	了然於心
部件	零件
零部件	散裝零件
镇子	城鎮
裹屍袋	遺體袋
集裝箱	貨櫃
衝壓聲	冲壓聲
呵斥	喝斥